S,S,S,S,S,S,S,W,S,S
S,S,S,P,S,S,S,S,P,S
S,S,S,S,S,S,S,P,S,S
S,S,S,S,S,S,S,S,S,S
S,S,S,S,S,S,S,S,S,P
S,S,P,S,S,P,S,S,S,S
S,S,S,S,S,S,S,S,S,S
S,S,W,S,S,S,S,S,W,S
S,S,S,S,S,S,S,S,G,P
S,S,S,P,S,S,S,S,S,S